1100001000011
1000110100111
0010000000001
1000001001011
10010S0001001
1010100010101
0000101000001
1011011101011